3HH13HH13HH13HH13HH13HH1
4HH23HH13HH13HH13HH13HH1
FLLL3HH13HH13HH13HH13HH1
SSSSSSSSSSSSSSSSSSSS3HH1
SSSSSSSSSSSSSSSSSSSS3HH1
SSSSSSSSSSSSSSSSSSSS3HH1
SSSSSSSSSSSSSSSSSSSS3HH1
SSSSSSSSSXSSSSSSSSSS3HH1
SSSSXSSSSXSSSSSXSSSS3HH1
SSSSSSSSSXSSSSSSSSSS3HH1